4 4 4 4 4 4 4 4 4 4 4 4 4 4 4 4 4 4 4 4 4 4 4 4 4 4 4 4 4 4 4 4 4 4 4 4 4 4 4 4 4 4 4 4 4 4 4 4 4 4 
4 4 4 4 4 4 4 4 4 4 4 4 4 4 4 4 4 4 4 4 4 4 4 4 4 4 4 4 4 4 4 4 4 4 4 4 4 4 4 4 4 4 4 4 4 4 4 4 4 4
4 4 4 4 4 4 4 4 4 4 4 4 4 4 4 4 4 4 4 4 4 4 4 4 4 4 4 4 4 4 4 4 4 4 4 4 4 4 4 4 4 4 4 4 4 4 4 4 4 4 
4 4 4 4 4 4 4 4 4 4 4 4 4 4 4 4 4 4 4 4 4 4 4 4 4 4 4 4 4 4 4 4 4 4 4 4 4 4 4 4 4 2 2 4 4 4 4 4 4 4 
4 4 4 4 4 4 4 4 4 4 4 4 4 4 4 4 4 4 4 4 4 4 4 4 4 4 4 4 4 4 4 4 4 4 4 4 4 4 4 2 2 2 2 2 2 2 4 4 4 4 
4 4 4 4 4 4 4 4 4 4 4 4 4 4 4 4 4 4 4 4 4 4 4 4 4 4 4 4 4 4 4 4 4 4 4 4 4 4 2 2 2 2 2 2 2 2 2 2 4 4 
4 4 4 4 4 4 4 4 4 4 4 4 4 4 4 4 4 4 4 4 4 4 4 4 4 4 4 4 4 4 4 4 4 4 4 4 4 4 2 2 2 0 4 0 2 2 2 2 4 4 
4 4 4 4 4 4 4 4 4 4 4 4 4 4 4 4 4 4 4 4 4 4 4 4 4 4 4 4 4 4 4 4 4 4 4 4 4 4 2 2 4 0 4 0 0 2 2 2 4 4 
4 4 4 4 4 4 4 4 0 0 4 4 0 0 0 0 0 0 0 0 0 0 0 4 4 4 4 4 4 0 0 0 0 4 0 0 0 2 2 2 0 0 0 0 2 2 2 2 4 4
4 4 4 4 4 4 4 4 0 0 4 4 0 0 0 4 0 0 0 0 0 0 0 4 2 2 2 2 4 0 8 11 9 4 0 0 4 2 2 2 0 4 2 2 2 2 2 4 4 4
4 4 4 4 4 4 4 4 0 0 4 4 0 0 0 0 0 0 8 11 11 9 0 2 2 2 2 2 0 0 13 5 12 0 0 0 0 4 2 2 2 2 2 2 2 2 2 4 4 4 
4 4 4 4 4 4 4 4 0 0 4 4 4 4 4 4 4 0 13 5 5 12 0 2 2 2 2 2 2 0 13 16 7 0 0 0 0 4 2 2 2 2 4 4 2 2 4 4 4 4 
4 4 4 4 4 4 4 4 0 0 0 0 0 4 0 0 4 4 6 10 17 12 2 2 2 2 2 0 8 11 15 12 4 0 0 0 0 0 0 0 0 0 4 2 2 2 4 4 4 4 
4 4 4 4 4 4 4 4 0 0 0 0 0 0 0 0 0 4 0 0 13 14 9 0 2 2 2 2 13 16 10 7 0 0 4 0 0 0 0 2 2 2 2 2 2 2 4 4 4 4
4 4 4 4 4 4 4 4 0 0 0 0 0 0 0 4 0 4 0 0 6 17 12 4 0 2 2 0 13 12 4 0 0 0 0 0 3 0 2 2 2 0 4 2 2 4 4 4 4 4
4 4 4 4 4 4 4 4 0 0 0 0 0 0 0 0 0 4 0 4 0 13 12 0 0 0 0 0 13 12 0 0 0 0 0 3 3 3 2 0 0 0 4 4 4 4 4 4 4 4 
4 4 4 4 4 4 4 4 0 0 0 0 0 0 0 0 0 4 4 4 0 13 12 0 0 0 8 11 15 12 0 0 0 0 2 2 3 3 3 0 0 0 4 4 4 4 4 4 4 4 
4 4 4 4 4 4 4 4 0 0 2 2 2 0 0 0 0 0 0 0 4 13 14 11 11 11 15 5 5 12 0 0 0 2 2 2 0 0 0 0 0 0 4 4 4 4 4 4 4 4  
4 4 4 4 4 4 4 4 0 2 2 0 2 2 3 0 0 0 0 8 11 15 5 5 5 5 5 10 10 7 0 0 2 2 0 0 0 0 0 0 0 4 4 4 4 4 4 4 4 4 
4 4 4 4 4 4 4 4 0 2 2 0 0 0 3 3 0 0 0 13 5 5 5 5 5 3 3 2 2 2 2 2 2 4 0 0 0 0 0 0 0 0 4 4 4 4 4 4 4 4 
4 4 4 4 4 4 4 4 0 2 2 4 0 0 3 3 2 0 0 13 5 5 16 10 10 3 3 2 2 2 2 2 0 4 0 4 0 0 0 0 4 0 4 4 4 4 4 4 4 4
4 4 4 4 4 4 4 4 2 2 2 0 0 0 0 3 2 2 2 6 10 10 7 2 2 3 3 2 2 2 2 8 9 0 0 0 0 0 0 0 4 0 4 4 4 4 4 4 4 4
4 4 4 4 4 4 4 4 2 2 2 0 0 0 0 0 0 0 2 2 2 2 2 2 2 3 3 2 2 2 2 13 12 0 0 0 0 0 0 0 0 0 4 4 4 4 4 4 4 4
4 4 4 4 4 4 4 4 2 2 0 0 0 0 0 0 0 0 8 11 9 2 2 2 0 0 0 0 2 2 8 15 12 0 0 0 0 0 0 0 0 4 4 4 4 4 4 4 4 4
4 4 4 4 4 4 4 4 2 2 0 0 0 0 4 4 0 0 13 5 3 3 3 3 0 0 0 0 3 3 3 16 7 0 4 0 0 0 0 0 0 0 4 4 4 4 4 4 4 4
4 4 4 4 4 4 4 4 2 2 0 0 0 4 4 4 0 0 13 5 3 3 3 3 0 0 0 0 3 3 3 12 0 0 0 0 0 0 0 4 0 0 4 4 4 4 4 4 4 4
4 4 4 4 4 4 4 4 2 2 0 4 4 4 0 0 0 0 13 5 12 2 2 2 0 0 0 0 2 2 13 12 0 0 4 4 4 4 4 4 4 4 4 4 4 4 4 4 4 4
4 4 4 4 4 4 4 2 2 2 0 4 0 0 8 11 11 11 15 5 14 9 2 2 2 3 3 2 2 2 13 12 0 0 4 1 1 1 1 1 1 4 4 4 4 4 4 4 4 4
4 4 4 4 2 2 2 2 2 0 4 4 8 11 15 16 10 10 10 17 5 14 9 2 2 3 3 2 2 2 13 14 9 0 4 1 3 3 3 3 1 4 4 4 4 4 4 4 4 4
4 4 2 2 2 2 2 2 0 0 4 0 13 5 16 7 0 0 4 13 5 5 14 11 11 3 3 9 2 2 13 16 7 0 4 1 3 3 3 3 1 4 4 4 4 4 4 4 4 4
2 2 2 2 2 4 4 4 0 4 4 0 13 16 7 0 0 0 4 6 10 10 10 17 5 5 5 12 2 2 6 7 4 4 4 1 3 3 3 3 1 4 4 4 4 4 4 4 4 4
2 2 2 2 2 4 4 4 4 4 0 8 15 12 0 0 0 0 4 4 0 0 0 6 17 5 16 7 2 2 2 0 4 4 0 1 1 3 1 1 1 4 4 4 4 4 4 4 4 4 
2 2 2 4 4 4 4 4 0 0 0 13 5 12 0 4 0 0 0 0 0 0 0 0 13 5 12 0 2 2 2 4 4 0 0 0 8 11 9 0 0 0 4 4 4 4 4 4 4 4 
4 4 4 4 4 4 4 4 0 4 0 13 5 12 0 0 0 4 0 0 0 0 4 0 13 5 12 0 0 0 2 2 4 0 4 0 13 5 12 0 0 0 4 4 4 4 4 4 4 4 
4 4 4 4 4 4 4 4 0 0 0 1 3 1 0 0 4 4 4 0 0 0 0 0 13 5 12 0 0 0 2 2 2 0 0 13 5 12 0 4 0 0 4 4 4 4 4 4 4 4 
4 4 4 4 4 4 4 4 0 1 1 1 3 1 1 0 0 0 0 0 0 0 0 0 13 5 12 0 0 0 0 2 2 0 4 4 13 5 12 0 0 0 4 4 4 4 4 4 4 4
4 4 4 4 4 4 4 4 0 1 3 3 3 3 1 1 1 1 1 1 0 0 8 11 15 5 14 11 11 9 0 2 2 8 11 11 15 5 12 0 0 0 4 4 4 4 4 4 4 4 
4 4 4 4 4 4 4 4 0 1 3 3 3 3 3 3 3 3 3 1 8 11 15 5 5 5 5 5 5 12 3 3 3 13 5 5 5 5 12 0 0 0 4 4 4 4 4 4 4 4 
4 4 4 4 4 4 4 4 0 1 3 3 3 3 1 3 3 3 3 1 6 10 10 10 10 10 10 17 5 12 3 3 3 13 5 16 10 10 7 0 0 0 4 4 4 4 4 4 4 4 
4 4 4 4 4 4 4 4 4 1 3 3 3 3 1 1 1 1 1 1 0 0 4 0 0 0 0 6 10 7 2 0 0 6 10 7 0 0 0 0 0 0 4 4 4 4 4 4 4 4
4 4 4 4 4 4 4 4 4 1 1 1 1 1 1 0 0 0 0 0 0 0 0 0 0 0 0 2 2 2 2 0 0 0 0 0 0 0 0 0 0 0 4 4 4 4 4 4 4 4
4 4 4 4 4 4 4 4 0 0 0 0 0 0 0 0 4 0 0 0 0 0 0 4 0 0 0 2 2 0 0 0 0 0 0 0 0 0 0 0 4 0 4 4 4 4 4 4 4 4 
4 4 4 4 4 4 4 4 4 4 4 4 4 4 4 4 4 4 4 4 4 4 4 4 4 4 4 2 2 4 4 4 4 4 4 4 4 4 4 4 4 4 4 4 4 4 4 4 4 4 
4 4 4 4 4 4 4 4 4 4 4 4 4 4 4 4 4 4 4 4 4 4 4 4 4 4 2 2 2 4 4 4 4 4 4 4 4 4 4 4 4 4 4 4 4 4 4 4 4 4
4 4 4 4 4 4 4 4 4 4 4 4 4 4 4 4 4 4 4 4 4 4 4 4 4 4 2 2 4 4 4 4 4 4 4 4 4 4 4 4 4 4 4 4 4 4 4 4 4 4 
4 4 4 4 4 4 4 4 4 4 4 4 4 4 4 4 4 4 4 4 4 4 4 4 2 2 2 4 4 4 4 4 4 4 4 4 4 4 4 4 4 4 4 4 4 4 4 4 4 4
4 4 4 4 4 4 4 4 4 4 4 4 4 4 4 4 4 4 4 4 4 4 4 2 2 4 4 4 4 4 4 4 4 4 4 4 4 4 4 4 4 4 4 4 4 4 4 4 4 4
4 4 4 4 4 4 4 4 4 4 4 4 4 4 4 4 4 4 4 4 4 4 2 2 2 2 2 4 4 4 4 4 4 4 4 4 4 4 4 4 4 4 4 4 4 4 4 4 4 4
4 4 4 4 4 4 4 4 4 4 4 4 4 4 4 4 4 4 4 4 4 4 2 2 2 2 2 2 4 4 4 4 4 4 4 4 4 4 4 4 4 4 4 4 4 4 4 4 4 4
4 4 4 4 4 4 4 4 4 4 4 4 4 4 4 4 4 4 4 4 4 4 4 2 2 2 2 2 4 4 4 4 4 4 4 4 4 4 4 4 4 4 4 4 4 4 4 4 4 4